8
320    208
0    	0    
320     0
640     0
960     0
1280    0
1600    0
1920    0
2240    0